11111111111111111111111111111
1C00C00C000000C000000C000C001
1M010101000100010100010101C11
1C000C00C000000C000C00C000011
10100010100010100010101000111
1C00C00C000000C00000MC000C001
10101000101010001010001010111
1C000C000C00C000000C00C000011
10101010100010001010001010111
1C00C000000C00C00C00000MC0011
1M010001010100010100010101011
1C000C00C000000C000C00C000111
10101000101010001010001010111
1C100000C00C000000C00C000C011
1M111100010100010101000100011
110P00C000000000C00E000000011
11111111111111111111111111111