111111111111111111
1P00000C0000000011
101010101010101011
1C000000C000000011
101010101010101011
1C000C000C00000011
101000101010101011
1C00000000C0000011
101010101000101011
1C000C000C00000011
101000101010101011
1C000000000C000111
101010101010101011
1C000C000C00000011
101010001010101011
1C0000000C00000011
1E0000000000000011
111111111111111111