111111111111111111111111111111111
1P0000C000000000C00C000000C000001
101000101010100010001010101010101
1C000C000000000C0000000C000C00011
101010101010101010101010101000101
1C000C00000C0000000C000C000000001
101010001010100010101010101010101
1C000000C00000C000000000C000C0011
101010101000100010101010101010101
1C00C0000000C0000C000C00000C00011
101000101010100010101010100010101
1C000000C000C000000000C000000C011
101010101010100010101010101010101
1C00C00000C000000C000C000000C0011
101000101010101000100010101010101
1C00000C00C0000000C000C0000000011
1E0000000000000000000000000000011
111111111111111111111111111111111