1111111111111111111111111111
1C0000C00000C000000C00000C01
1010101010101010101010101011
1C0000C00000C000C000C0000001
1010001010001010100010100011
1C000000C000C0000000C000C001
1010101010101010101010101011
1C000C00000C000000C000C00001
1010100010101000101010001011
1C000000C000C000C0000000C001
1010101010101010101010101011
1C000C000000C00000C000C00011
1010101000101010001010101011
1C00000C0000C000C000000C0011
1010101010101010101010101011
1C000C00000C000C00000C000011
1010100010100010100010101011
1P0000C000000000C00E00000001
1111111111111111111111111111