11111111111111111
1P0000000C0000001
10101000101000101
1C00C00000C000001
10101010100010101
1C000C000C0000001
10101010100010101
1C00000C000C00001
10101000101000101
1C000C00000C00001
10101010101010101
1C00000C00000E001
10101010101010101
1C000C000C0000001
10101010100010101
1C00000C000C00001
11000000000000001
11111111111111111