111111111111111111111111111111111111
1P0000000000000000000000000000000001
101011010100100101010001010101010101
1C000C00000000000000C0000000C0000001
101010100101000101010001010101010101
1C00000C000C0000C0000000C000C0000001
101010100100010101000101010101010101
1C0000000000000000C000C000C000000001
101010101010101010100101010101010101
1C000C000C000C0000C000C000000C000001
101010101010001010101010100010101011
1C000000000C0000C000000000C000100001
101010101010101010101010101010101011
1C000C000000C000000000C000C000000001
101010101010001010101010100010101011
1C000000C000C0000C000C000000C0000001
101010101010101010100101010101010101
1C000C00000000000000C0000000C0000001
1E0000000000000000000000000000000001
111111111111111111111111111111111111